111111111111111111111111111111111111
100P000000100000000010000000010000E1
100000000010C00000001000000001000001
111111000010000000001000000001000001
100000000011111000000000000001000001
100000000000001000000001XX0XX1000001
100000100000001000000001000000000001
1000001XXX0XXX1000000001000000111111
100000100000000000000001000000100C01
100C00100000000000000001000000000001
111111111111111111111111111111111111
