111111111
100C001E1
100000001
111111111
