111111111111111111111111111111
1E0000100000001C10010011111111
1C000010000000C0C0100011100111
1C00000000000C000C100011100111
1C000001000000C0C0100011111111
100000100000000C00001P11111111
111111111111111111111111111111
